slug	title	like_count
contracted-house-cleaning-service-casy	掃除代行サービスのCaSyを契約	5
control-sesame-home-assistant	SESAMEスマートロックを Home Assistant から制御する方法	5
ubiquiti-unifi-express-review-hardware-initial-setup	Ubiquiti UniFi Express レビュー: ハードウェア & 初期セットアップ編	5
change-remember-milk-ticktick	Remember The Milk からTickTickに乗り換え	4
check-points-airalo-esim-no-service	AiraloのeSIMが使えないときに確認すべきポイント	4
bought-shell-logicool-mx-anywhere-2s	Logicool MX Anywhere 2S の外装を購入	3
bought-apple-mac-studio-2022	Apple Mac Studio (2022) を購入	2
ubiquiti-unifi-express-review-monitoring	Ubiquiti UniFi Express レビュー: 監視編	2
change-mic-speaker-shortcut	Macのマイクとスピーカーをまとめてショートカットで変更する方法	1
open-sbi-shinsei-bank	SBI新生銀行を開設	1
bought-daikin-s224ates	DAIKIN S224ATES を購入	1
bought-fostex-pm-submini2	FOSTEX PM-SUBmini2 を購入	1
desk-recipe-2024	2024年のデスクレシピ	1
stayed-bangkok-marriott-marquis-queens-park	Bangkok Marriott Marquis Queen’s Park に宿泊	1
change-google-chrome-arc	Google Chrome からArcに乗り換え	1
resolved-wordpress-auto-links-strings-beginning-pound-hashtag	[解決済み] WordPressで#で始まる文字列がハッシュタグとして自動リンクされる	1
bought-final-vr2000-gaming	final VR2000 for Gaming を購入	1
bought-gl-inet-gl-ar750s-ext-slate	GL.iNet Slate GL-AR750S-Ext を購入	1
detect-specific-person-home-bluetooth	Bluetoothで特定の人物が在宅しているかどうかを検知する方法	1
bought-brother-hl-l3230cdw	Brother HL-L3230CDW を購入	1
ubiquiti-unifi-udm-se-review-hardware-initial-setup	Ubiquiti UniFi UDM-SE レビュー: ハードウェア & 初期セットアップ編	1
required-documents-procedures-departure-japan-entry-singapore	日本出国からシンガポール入国に必要な書類と流れ（2022年8月時点）	1
bought-apple-macbook-pro-14-inch-2021	Apple MacBook Pro (14-inch, 2021) を購入	1
required-documents-procedures-business-trip-singapore-return-japan	シンガポール出張から日本帰国に必要な書類と流れ（2022年9月時点）	1
solved-receive-bluetooth-connection-requests-repeatedly	[解決済み] 不明なデバイスからのBluetooth接続要求がMacで繰り返される	1
bought-inaba-kin-no-dashi-pouch	いなば 金のだし パウチ を購入	1
